XXXXXXXXXXX
XXS      AX
XXXXXXXXX X
XXXXX XX  X
X         X
XXXXXX XXXX
XXXXXXAXXXX
XXXXXXXXXXX